SR.NO,image-links,likes,Comments,trending score,Product Description
1,https://instagram.fbom26-2.fna.fbcdn.net/v/t51.2885-15/295707700_585532483185023_5493845213032717938_n.jpg?stp=dst-webp_e35&cb=9ad74b5e-be52112b&_nc_ht=instagram.fbom26-2.fna.fbcdn.net&_nc_cat=111&_nc_ohc=i3PgDCHuhUMAX-KqwIT&edm=ALQROFkBAAAA&ccb=7-5&ig_cache_key=Mjg4OTg5OTQ1OTg2ODU1MTUyNw%3D%3D.2-ccb7-5&oh=00_AT_aG2MQQz2D20SicmUkCeEJ0MILcqoar_K1kIiLNQz80w&oe=62E527A3&_nc_sid=30a2ef,49500,203,49703,Long v neck knitted dress
2,https://instagram.fbom26-1.fna.fbcdn.net/v/t51.2885-15/295082828_7573039012766378_3295513487896826955_n.jpg?stp=dst-webp_e35&cb=9ad74b5e-be52112b&_nc_ht=instagram.fbom26-1.fna.fbcdn.net&_nc_cat=1&_nc_ohc=tIfojRirY68AX_Y3qTv&edm=ALQROFkBAAAA&ccb=7-5&ig_cache_key=Mjg4OTQxMDkxMDY3MTYyODAwNQ%3D%3D.2-ccb7-5&oh=00_AT9qLU8lsRhNa2G6s85sBgmDv6pwldOfuYgPuvg82hkvTQ&oe=62E59E6A&_nc_sid=30a2ef,49400,203,49603,Vintage Distressed Teal Learher Crossbody Bag
3,https://instagram.fbom26-2.fna.fbcdn.net/v/t51.2885-15/295132060_167428139181724_8508938222247181655_n.jpg?stp=dst-webp_e35&cb=9ad74b5e-be52112b&_nc_ht=instagram.fbom26-2.fna.fbcdn.net&_nc_cat=104&_nc_ohc=DK7WRsGUo3sAX-iJhZf&edm=ALQROFkBAAAA&ccb=7-5&ig_cache_key=Mjg4OTkwMDY5NjE4NDQ1MDA2OA%3D%3D.2-ccb7-5&oh=00_AT8e7JmgKJED7fN_3VZ3BZbEB8LuTjSX2XpNtz_75b8Rtg&oe=62E59DD2&_nc_sid=30a2ef,9217,103,9320,Peate Red (V) pleated crossbody bag
4,https://instagram.fbom26-1.fna.fbcdn.net/v/t51.2885-15/294745233_748160149758219_6047128654538404444_n.webp?stp=dst-webp_e35&cb=9ad74b5e-be52112b&_nc_ht=instagram.fbom26-1.fna.fbcdn.net&_nc_cat=103&_nc_ohc=TZs3YwXAk6sAX_IkthQ&edm=ALQROFkBAAAA&ccb=7-5&ig_cache_key=Mjg4ODY0NTQ4OTU5MjU5MDYzNA%3D%3D.2-ccb7-5&oh=00_AT9utvFWeq4AMDafbqisHt-F_TCd858NK_PDApmZ0rgkhg&oe=62E5CF37&_nc_sid=30a2ef,9203,102,9305,Jacksons Jute Bags
5,https://instagram.fbom26-1.fna.fbcdn.net/v/t51.2885-15/294885171_586755052832149_5583932336955972387_n.webp?stp=dst-webp_e35&cb=9ad74b5e-be52112b&_nc_ht=instagram.fbom26-1.fna.fbcdn.net&_nc_cat=101&_nc_ohc=gvUsH5zPyhoAX8TFxVn&edm=ALQROFkBAAAA&ccb=7-5&ig_cache_key=Mjg4Nzk2MTE0MzI1ODQ4MjYxNg%3D%3D.2-ccb7-5&oh=00_AT9ECYWrl7XgTgcBTancawXnenuX0vNU92rWjqPSmR3f_w&oe=62E5177D&_nc_sid=30a2ef,3378,27,3405,Cora Strapless Maxi
6,https://instagram.fbom26-1.fna.fbcdn.net/v/t51.2885-19/292442553_1779045015764485_5148302503756276568_n.jpg?stp=dst-jpg_s150x150&_nc_ht=instagram.fbom26-1.fna.fbcdn.net&_nc_cat=101&_nc_ohc=KuTG0sMQGVUAX88PesM&edm=ALQROFkBAAAA&ccb=7-5&oh=00_AT-N-bOuUP18ssI3fnIn-QEbWOY3MAlNCaMW4reZuUD_2A&oe=62E44D70&_nc_sid=30a2ef,3378,27,3405,Curl Hair Care
7,https://instagram.fbom26-1.fna.fbcdn.net/v/t51.2885-19/293525856_177815171318013_6727565799598464222_n.jpg?stp=dst-jpg_s150x150&_nc_ht=instagram.fbom26-1.fna.fbcdn.net&_nc_cat=109&_nc_ohc=ebw14RzdeagAX82ucJT&edm=ALQROFkBAAAA&ccb=7-5&oh=00_AT8uKGluYGTeBmqo5bmMyuhTAVwH0UEM-O6mFWeSTriCxw&oe=62E5EC29&_nc_sid=30a2ef,3303,28,3331,Tiger print fleece jacket
8,https://instagram.fbom26-2.fna.fbcdn.net/v/t51.2885-15/295358011_551901250055963_5215379465917707016_n.webp?stp=dst-webp_e35&cb=9ad74b5e-be52112b&_nc_ht=instagram.fbom26-2.fna.fbcdn.net&_nc_cat=111&_nc_ohc=QrzZN_OSoKsAX8RJRVU&edm=ALQROFkBAAAA&ccb=7-5&ig_cache_key=Mjg4OTQxNDc1OTU0OTAyNjY1NQ%3D%3D.2-ccb7-5&oh=00_AT9BJhtHiCn2sWiVDjrV2OryHSdvxFqRvahaJqK2Px6wcA&oe=62E49B48&_nc_sid=30a2ef,3289,28,3317,women's Long sleeve lapel Collar casual button down chiffon shirts
9,https://instagram.fbom26-1.fna.fbcdn.net/v/t51.2885-19/161717846_111671924233410_4773403480315147214_n.jpg?stp=dst-jpg_s150x150&_nc_ht=instagram.fbom26-1.fna.fbcdn.net&_nc_cat=106&_nc_ohc=0hTsm9N_PeAAX9N8rml&edm=ALQROFkBAAAA&ccb=7-5&oh=00_AT-7Qhd_cbeg9B4BosvPfg8aTeMazLMCTaq9aIGJqgtKCg&oe=62E54981&_nc_sid=30a2ef,1958,28,1986,Beton Tshirt
10,https://instagram.fbom26-1.fna.fbcdn.net/v/t51.2885-15/295853381_3117121331871881_5592192042679239517_n.webp?stp=dst-webp_e35&cb=9ad74b5e-be52112b&_nc_ht=instagram.fbom26-1.fna.fbcdn.net&_nc_cat=105&_nc_ohc=LBT0DL9TKv8AX-kgo8A&edm=ALQROFkBAAAA&ccb=7-5&ig_cache_key=Mjg4OTg5Mzk5MjcxOTY1NDc2MQ%3D%3D.2-ccb7-5&oh=00_AT9s99DOWwk-H8yK3rpi8Zd2_nW7Zwol9xki8R17wqWfeA&oe=62E457F7&_nc_sid=30a2ef,1502,45,1547,Chloe lightweight denim trousers
11,https://instagram.fbom26-2.fna.fbcdn.net/v/t51.2885-15/295066448_873330466976620_5003276304968031326_n.webp?stp=dst-webp_e35&cb=9ad74b5e-be52112b&_nc_ht=instagram.fbom26-2.fna.fbcdn.net&_nc_cat=104&_nc_ohc=km4dMEP9WQ8AX-u8WDa&edm=ALQROFkBAAAA&ccb=7-5&ig_cache_key=Mjg4ODc0MDE2Mzg1MDEwNjkzNQ%3D%3D.2-ccb7-5&oh=00_AT8Tj94dtFW_rQf_4GHyCE0L1Cuqbo-VXmthyaPXRvdecQ&oe=62E5B9D4&_nc_sid=30a2ef,1499,45,1544,Womens walking sandals
12,https://instagram.fbom26-1.fna.fbcdn.net/v/t51.2885-15/295273473_567021235097449_7178819274189299549_n.jpg?stp=dst-webp_e35&cb=9ad74b5e-be52112b&_nc_ht=instagram.fbom26-1.fna.fbcdn.net&_nc_cat=101&_nc_ohc=3Bqzjo0SxlkAX86bS43&edm=ALQROFkBAAAA&ccb=7-5&ig_cache_key=Mjg4OTUwNzA5NDQ3NjMwMzAwMg%3D%3D.2-ccb7-5&oh=00_AT9QHqRX01372wzCUyLRQOrqAnDsHXGNSd7Cx_dYEafe2g&oe=62E5B272&_nc_sid=30a2ef,819,24,843,womens sparkly sequins waistcoat
13,https://instagram.fbom26-2.fna.fbcdn.net/v/t51.2885-19/290069625_355909399826532_8121526465293477518_n.jpg?stp=dst-jpg_s150x150&_nc_ht=instagram.fbom26-2.fna.fbcdn.net&_nc_cat=100&_nc_ohc=C6Y1t7a2HrMAX8GKquZ&edm=AId3EpQBAAAA&ccb=7-5&oh=00_AT-Pa1lZ3qTMOQcu5XVaCVO2sPJdalyMsx2OTXYopcPaPg&oe=62E5207D&_nc_sid=705020,597,10,607,Radiohead painting
14,https://instagram.fbom26-2.fna.fbcdn.net/v/t51.2885-15/295236658_1634039923635863_1710827572652024664_n.webp?stp=dst-webp_e35&cb=9ad74b5e-be52112b&_nc_ht=instagram.fbom26-2.fna.fbcdn.net&_nc_cat=111&_nc_ohc=ml3GjBj2bTgAX_eE4Bs&edm=ALQROFkBAAAA&ccb=7-5&ig_cache_key=Mjg4OTg5NTkyMzg5NzMxNDg1Ng%3D%3D.2-ccb7-5&oh=00_AT8orJXchh2JxwtvXytJsc24lavYduUKLvma-HY3JsOWPw&oe=62E54E0E&_nc_sid=30a2ef,597,10,607,Mens Open pointed collar shirts
15,https://instagram.fbom26-2.fna.fbcdn.net/v/t51.2885-19/277454156_368762551823582_8427463659301959233_n.jpg?stp=dst-jpg_s150x150&_nc_ht=instagram.fbom26-2.fna.fbcdn.net&_nc_cat=102&_nc_ohc=QpnUUYD5ZvAAX_spqQT&edm=AId3EpQBAAAA&ccb=7-5&oh=00_AT-YRd8lDyrXtAbaZYjTpqzxqUH3CZDxppa9-wiY7DuKPQ&oe=62E4352C&_nc_sid=705020,562,36,598,Limited Edition poster
16,https://instagram.fbom26-2.fna.fbcdn.net/v/t51.2885-19/50252788_386796068753138_1184017578930995200_n.jpg?stp=dst-jpg_s150x150&_nc_ht=instagram.fbom26-2.fna.fbcdn.net&_nc_cat=102&_nc_ohc=Vnz1UUzaSIcAX_Xw7_w&edm=ALQROFkBAAAA&ccb=7-5&oh=00_AT_ctjDbSnQSZ_KrYq6tFe5LeTxfRLyPVNCFLNf-AAS3Lg&oe=62E5742D&_nc_sid=30a2ef,562,36,598,Entertainment magazine
17,https://instagram.fbom26-1.fna.fbcdn.net/v/t51.2885-15/295252834_2193292607513442_6537025270671233779_n.webp?stp=dst-webp_e35&cb=9ad74b5e-be52112b&_nc_ht=instagram.fbom26-1.fna.fbcdn.net&_nc_cat=106&_nc_ohc=5WsbsxZXQTsAX9eZYMk&edm=ALQROFkBAAAA&ccb=7-5&ig_cache_key=Mjg4OTkwMTQ2MjIxMjk1NjIzNQ%3D%3D.2-ccb7-5&oh=00_AT9s4qY4U5WZwBHBeLhPg9wsWEd_HxSXpvLxvMCBlEehVw&oe=62E5405B&_nc_sid=30a2ef,249,2,251,Sustainable cotton midi dress
18,https://instagram.fbom26-2.fna.fbcdn.net/v/t51.2885-19/259473757_133786819017854_4881976633954205255_n.jpg?stp=dst-jpg_s150x150&_nc_ht=instagram.fbom26-2.fna.fbcdn.net&_nc_cat=102&_nc_ohc=Ook1gCZfj1YAX9VVmUM&edm=APU89FABAAAA&ccb=7-5&oh=00_AT984bYkcwFNFBDaKoLCAzpHevDdE5ubvtMlfNo-pzb4WQ&oe=62E41E5A&_nc_sid=86f79a,246,2,248,short sleeve shirt
19,https://instagram.fbom26-2.fna.fbcdn.net/v/t51.2885-15/295130089_1806008226400234_5403883936766496353_n.jpg?stp=dst-webp_e35&cb=9ad74b5e-be52112b&_nc_ht=instagram.fbom26-2.fna.fbcdn.net&_nc_cat=110&_nc_ohc=9TRtBriB7J8AX_hBFWn&tn=ujwsdHpCfznLzE8S&edm=ALQROFkBAAAA&ccb=7-5&ig_cache_key=Mjg4OTkwMTYxNzQyODMzMjk3OQ%3D%3D.2-ccb7-5&oh=00_AT_dVYN_8gYcUTpYrTCiVCLzjCuL1B5F1TB-1xlRqrB2Ow&oe=62E4F669&_nc_sid=30a2ef,31,3,34,Plaid long sleeve tunic top tee
20,https://instagram.fbom26-1.fna.fbcdn.net/v/t51.2885-15/295582694_836388487747578_5281359314785475316_n.webp?stp=dst-webp_e35&cb=9ad74b5e-be52112b&_nc_ht=instagram.fbom26-1.fna.fbcdn.net&_nc_cat=106&_nc_ohc=yVocRGh2JzkAX-gL96x&edm=ALQROFkBAAAA&ccb=7-5&ig_cache_key=Mjg4OTkwMTg1MTA2Njg0NDA0OQ%3D%3D.2-ccb7-5&oh=00_AT8hgjQNyiqmx6HGvW-GMtl5tQ8WrvEMWSRpvXS3ZtdRTQ&oe=62E536C2&_nc_sid=30a2ef,3,0,3,berani dress
21,https://instagram.fbom26-2.fna.fbcdn.net/v/t51.2885-19/280947508_382973853766202_1438325813910231461_n.jpg?stp=dst-jpg_s150x150&_nc_ht=instagram.fbom26-2.fna.fbcdn.net&_nc_cat=102&_nc_ohc=F24gTU3AC50AX_RVLRE&edm=ALQROFkBAAAA&ccb=7-5&oh=00_AT85QD5XvxgcGr-zd99jCt5MsOi3j8Qf9gBOkpQqD9cn-g&oe=62E4E455&_nc_sid=30a2ef,1,1,2,Floral embroided kurta
